12 12 12 12 12 12 12 12 12 12 12 12 12 12 12 12 12 12 12 12 12 12 12 12 12 12 12 12 12 12 12 12 12 12 12 12 12 12 12 12 12 12 12 12 12 12 12 12 12 12
12 12 12 12 12 12 12 12 12 12 12 12 12 12 12 12 12 12 12 12 12 12 12 12 12 12 12 12 12 12 12 12 12 12 12 12 12 12 12 12 12 12 12 12 12 12 12 12 12 12
12 12 12 12 12 12 12 12 12 12 12 12 12 12 12 12 12 12 12 12 12 12 12 12 12 12 12 12 12 12 12 12 12 12 12 12 12 12 12 12 12 12 12 12 12 12 12 12 12 12
12 12 12 12 12 12 12 12 12 12 12 12 12 12 12 12 12 12 12 12 12 12 12 12 12 12 12 12 12 12 12 12 12 12 12 12 12 12 12 12 12 12 12 12 12 12 12 12 12 12
12 12 12 12 12 12 12 12 22 20 20 20 20 20 20 20 20 20 20 20 20 20 20 20 20 20 20 20 20 23 12 12 12 12 12 12 22 20 20 20 20 23 12 12 12 12 12 12 12 12
12 12 12 12 12 12 12 12 18 10 10 41 10 10 41 10 10 41 10 10 41 10 10 10 35 33 36 10 10 17 12 12 12 12 12 12 18 10 10 10 10 17 12 12 12 12 12 12 12 12
12 12 12 12 12 12 12 12 18 10 10 10 10 10 10 10 10 10 10 10 10 10 10 10 31 26 30 10 10 19 20 20 20 20 20 20 21 10 10 10 10 17 12 12 12 12 12 12 12 12
12 12 12 12 12 12 12 12 18 10 10 10 10 10 10 10 10 10 10 10 10 10 10 10 31 26 30 10 10 10 10 10 10 10 10 10 10 10 10 10 10 17 12 12 12 12 12 12 12 12
12 12 12 12 12 12 12 12 18 10 10 41 10 10 41 10 10 41 10 10 41 10 10 10 31 26 30 10 10 10 10 10 10 10 10 10 10 10 10 10 10 17 12 12 12 12 12 12 12 12
12 12 12 12 12 12 12 12 18 10 10 10 10 10 10 10 10 10 10 10 10 10 10 10 31 26 30 10 10 41 41 41 41 41 41 41 41 41 41 10 41 17 12 12 12 12 12 12 12 12
12 12 12 12 12 12 12 12 18 10 14 15 15 15 15 16 10 10 10 10 10 10 10 10 31 26 30 10 10 41 41 41 41 41 41 41 41 41 41 10 41 17 12 12 12 12 12 12 12 12
12 12 12 12 12 12 12 12 18 10 17 12 12 12 12 18 10 41 10 10 41 10 10 10 31 26 30 10 10 41 41 41 10 10 41 10 10 10 10 10 41 17 12 12 12 12 12 12 12 12
12 12 12 12 12 12 12 12 18 10 17 12 12 12 12 18 10 10 10 10 10 10 10 10 31 26 30 10 10 41 10 10 10 10 41 10 10 10 10 10 41 17 12 12 12 12 12 12 12 12
12 12 12 12 12 12 12 12 18 10 17 12 12 12 12 18 10 10 10 10 10 10 10 10 31 26 30 10 10 41 10 10 10 10 41 10 10 41 10 10 41 17 12 12 12 12 12 12 12 12
12 12 12 12 12 12 12 12 18 10 17 12 12 12 12 24 15 15 15 15 16 10 10 10 31 26 30 10 10 41 10 10 41 10 41 10 10 41 41 10 41 17 12 12 12 12 12 12 12 12
12 12 12 12 12 12 12 12 18 10 17 12 12 12 12 12 12 12 12 12 18 10 10 10 31 26 30 10 10 41 10 10 41 10 10 10 10 41 10 10 41 17 12 12 12 12 12 12 12 12
12 12 12 12 12 12 12 12 18 10 17 12 12 12 12 12 12 12 12 12 18 10 10 10 31 26 30 10 10 41 10 10 41 10 10 10 10 41 10 10 41 17 12 12 12 12 12 12 12 12
12 12 12 12 12 12 12 12 18 10 17 12 12 12 12 12 12 12 12 12 24 15 15 16 31 26 30 10 10 10 10 10 41 10 10 41 41 41 10 10 10 17 12 12 12 12 12 12 12 12
12 12 12 12 12 12 12 12 18 10 17 12 12 12 12 12 12 12 12 12 12 12 12 18 31 26 30 10 10 10 10 10 41 10 10 10 10 41 10 10 10 17 12 12 12 12 12 12 12 12
12 12 12 12 12 12 12 12 18 10 17 12 12 12 12 12 12 12 12 12 12 12 12 18 31 26 30 10 10 41 41 41 41 41 41 41 41 41 41 41 41 17 12 12 12 12 12 12 12 12
12 12 12 12 12 12 12 12 18 10 19 20 20 20 20 20 20 20 20 20 20 20 20 21 31 26 30 10 10 10 10 10 10 10 10 10 10 10 10 10 10 17 12 12 12 12 12 12 12 12
12 12 12 12 12 12 12 12 18 10 35 33 33 33 33 33 33 33 33 33 33 33 33 33 34 26 32 33 33 33 33 33 33 33 33 33 33 33 33 33 36 17 12 12 12 12 12 12 12 12
12 12 12 12 12 12 12 12 18 10 31 26 26 26 26 26 26 26 26 26 26 26 26 26 26 26 26 26 26 26 26 26 26 26 26 26 26 26 26 26 30 17 12 12 12 12 12 12 12 12
12 12 12 12 12 12 12 12 18 10 37 28 28 28 28 28 28 28 28 28 28 28 28 28 29 26 27 28 28 28 28 28 28 28 28 28 28 28 28 28 38 17 12 12 12 12 12 12 12 12
12 12 12 12 12 12 12 12 18 10 10 10 10 10 10 10 10 10 10 10 10 10 10 10 31 26 30 10 10 10 10 10 10 10 10 10 10 10 10 10 10 17 12 12 12 12 12 12 12 12
12 12 12 12 12 12 12 12 18 10 41 41 41 41 41 41 41 41 41 41 10 10 10 10 31 26 30 10 10 41 41 10 10 10 10 10 10 10 10 41 41 17 12 12 12 12 12 12 12 12
12 12 12 12 12 12 12 12 18 10 41 41 41 41 41 41 41 41 41 41 41 10 10 10 31 26 30 10 10 10 10 10 10 10 10 10 10 10 10 10 10 17 12 12 12 12 12 12 12 12
12 12 12 12 12 12 12 12 18 10 41 41 10 10 10 10 10 10 10 10 41 41 10 10 31 26 30 10 10 10 10 10 10 10 10 10 10 10 10 10 10 17 12 12 12 12 12 12 12 12
12 12 12 12 12 12 12 12 18 10 41 41 10 10 10 10 10 10 10 10 10 41 41 10 31 26 30 10 10 10 10 10 10 10 41 41 10 10 10 10 10 17 12 12 12 12 12 12 12 12
12 12 12 12 12 12 12 12 18 10 41 41 10 10 10 10 10 10 10 10 10 10 41 41 31 26 30 10 10 10 10 10 10 10 10 10 10 10 10 10 10 17 12 12 12 12 12 12 12 12
12 12 12 12 12 12 12 12 18 10 41 41 10 10 10 10 10 10 10 10 10 10 10 41 31 26 30 10 10 10 10 10 10 10 10 10 10 10 10 10 10 17 12 12 12 12 12 12 12 12
12 12 12 12 12 12 12 12 18 10 41 41 10 10 10 10 10 10 10 10 10 10 10 41 31 26 30 10 10 41 41 10 10 10 10 10 10 10 10 41 41 17 12 12 12 12 12 12 12 12
12 12 12 12 12 12 12 12 18 10 41 41 35 33 33 33 33 33 33 33 33 33 33 33 34 26 30 10 10 10 10 10 10 10 10 10 10 10 10 10 10 17 12 12 12 12 12 12 12 12
12 12 12 12 12 12 12 12 18 10 41 41 31 26 26 26 26 26 26 26 26 26 26 26 26 26 30 10 10 10 10 10 10 10 10 10 10 10 10 10 10 17 12 12 12 12 12 12 12 12
12 12 12 12 12 12 12 12 18 10 41 41 37 28 28 28 28 28 28 28 28 28 28 28 29 26 30 10 10 41 41 41 41 41 41 41 41 41 41 41 41 17 12 12 12 12 12 12 12 12
12 12 12 12 12 12 12 12 18 10 41 41 10 10 10 10 10 10 10 10 10 10 10 41 31 26 30 10 10 41 10 10 10 41 10 10 10 40 40 40 40 17 12 12 12 12 12 12 12 12
12 12 12 12 12 12 12 12 18 10 41 41 10 10 10 10 10 10 10 10 10 10 10 41 31 26 30 10 10 41 10 41 10 41 41 10 10 10 39 39 40 17 12 12 12 12 12 12 12 12
12 12 12 12 12 12 12 12 18 10 41 41 10 10 10 10 10 10 10 10 10 10 41 41 31 26 30 10 10 41 10 41 10 10 10 10 10 40 39 45 40 17 12 12 12 12 12 12 12 12
12 12 12 12 12 12 12 12 18 10 41 41 10 10 10 10 10 10 10 10 10 41 41 10 31 26 30 10 10 41 10 41 10 41 10 10 10 40 40 40 40 17 12 12 12 12 12 12 12 12
12 12 12 12 12 12 12 12 18 10 41 41 10 10 10 10 10 10 10 10 41 41 10 10 31 26 30 10 10 41 10 41 10 41 41 10 10 10 10 10 10 17 12 12 12 12 12 12 12 12
12 12 12 12 12 12 12 12 18 10 41 41 41 41 41 41 41 41 41 41 41 10 10 10 31 26 30 10 10 41 10 41 10 10 41 10 10 10 10 10 41 17 12 12 12 12 12 12 12 12
12 12 12 12 12 12 12 12 18 10 41 41 41 41 41 41 41 41 41 41 10 10 10 10 31 26 30 10 10 41 10 41 41 10 41 10 10 10 10 10 41 17 12 12 12 12 12 12 12 12
12 12 12 12 12 12 12 12 18 10 10 10 10 10 10 10 10 10 10 10 10 10 10 10 31 26 30 10 10 41 10 10 41 10 41 10 10 10 10 10 41 17 12 12 12 12 12 12 12 12
12 12 12 12 12 12 12 12 18 10 10 10 10 10 10 10 10 10 10 10 10 10 10 10 31 26 30 10 10 41 10 10 41 41 41 41 41 41 41 41 41 17 12 12 12 12 12 12 12 12
12 12 12 12 12 12 12 12 18 10 10 10 10 10 10 10 10 10 10 10 10 10 10 10 37 28 38 10 10 10 10 10 10 10 10 10 10 10 10 10 10 17 12 12 12 12 12 12 12 12
12 12 12 12 12 12 12 12 24 15 15 15 15 15 15 15 15 15 15 15 15 15 15 15 15 15 15 15 15 15 15 15 15 15 15 15 15 15 15 15 15 25 12 12 12 12 12 12 12 12
12 12 12 12 12 12 12 12 12 12 12 12 12 12 12 12 12 12 12 12 12 12 12 12 12 12 12 12 12 12 12 12 12 12 12 12 12 12 12 12 12 12 12 12 12 12 12 12 12 12
12 12 12 12 12 12 12 12 12 12 12 12 12 12 12 12 12 12 12 12 12 12 12 12 12 12 12 12 12 12 12 12 12 12 12 12 12 12 12 12 12 12 12 12 12 12 12 12 12 12
12 12 12 12 12 12 12 12 12 12 12 12 12 12 12 12 12 12 12 12 12 12 12 12 12 12 12 12 12 12 12 12 12 12 12 12 12 12 12 12 12 12 12 12 12 12 12 12 12 12
12 12 12 12 12 12 12 12 12 12 12 12 12 12 12 12 12 12 12 12 12 12 12 12 12 12 12 12 12 12 12 12 12 12 12 12 12 12 12 12 12 12 12 12 12 12 12 12 12 12
