12 12 12 12 12 12 12 12 12 12 12 12 12 12 12 12 12 12 12 12 12 12 12 12 12 12 12 12 12 12 12 12 12 12 12 12 12 12 12 12 12 12 12 12 12 12 12 12 12 12
12 12 12 12 12 12 12 12 12 12 12 12 12 12 12 12 12 12 12 12 12 12 12 12 12 12 12 12 12 12 12 12 12 12 12 12 12 12 12 12 12 12 12 12 12 12 12 12 12 12
12 12 12 12 12 12 12 12 12 12 12 12 12 12 12 12 12 12 12 12 12 12 12 12 12 12 12 12 12 12 12 12 12 12 12 12 12 12 12 12 12 12 12 12 12 12 12 12 12 12
12 12 12 12 12 12 12 12 12 12 12 12 12 12 12 12 12 12 12 12 12 12 12 12 12 12 12 12 12 12 12 12 12 12 12 12 12 12 12 12 12 12 12 12 12 12 12 12 12 12
12 12 12 12 12 12 12 12 12 12 12 12 12 12 12 12 12 12 12 12 12 12 12 12 12 12 12 12 12 12 12 12 12 12 12 12 12 12 12 12 12 12 12 12 12 12 12 12 12 12
12 12 12 12 12 12 12 12 12 12 12 12 12 12 12 12 12 12 12 12 12 12 12 12 12 12 12 12 12 12 12 12 12 12 12 12 12 12 12 12 12 12 12 12 12 12 12 12 12 12
12 12 12 12 12 12 12 12 12 12 12 12 12 12 12 12 12 12 12 12 12 12 12 12 12 12 12 12 12 12 12 12 12 12 12 12 12 12 12 12 12 12 12 12 12 12 12 12 12 12
12 12 12 12 12 12 12 12 12 12 12 12 12 12 12 12 12 12 12 12 12 12 12 12 12 12 12 12 12 12 12 12 12 12 12 12 12 12 12 12 12 12 12 12 12 12 12 12 12 12
12 12 12 12 12 12 12 12 12 12 12 12 12 12 12 12 12 12 12 12 12 12 12 12 12 12 12 12 12 12 12 12 12 12 12 12 12 12 12 12 12 12 12 12 12 12 12 12 12 12
12 12 12 12 12 12 12 12 12 12 12 12 12 12 12 12 12 12 12 12 12 12 12 12 12 12 12 12 12 12 12 12 12 12 12 12 12 12 12 12 12 12 12 12 12 12 12 12 12 12
12 12 12 12 12 12 12 12 12 12 22 20 20 20 20 20 20 20 20 20 20 20 20 20 20 20 20 20 20 20 20 20 20 20 20 20 20 20 23 12 12 12 12 12 12 12 12 12 12 12
12 12 12 12 12 12 12 12 12 12 18 35 33 33 33 33 33 33 33 33 33 33 36 10 10 10 35 33 33 33 33 33 33 33 33 33 33 36 17 12 12 12 12 12 12 12 12 12 12 12
12 12 12 12 12 12 12 12 12 12 18 31 26 26 26 26 26 26 26 26 26 26 30 10 10 10 31 26 26 26 26 26 26 26 26 26 26 30 17 12 12 12 12 12 12 12 12 12 12 12
12 12 12 12 12 12 12 12 12 12 18 31 26 26 26 26 26 26 26 26 26 26 30 10 10 10 31 26 26 26 26 26 26 26 26 26 26 30 17 12 12 12 12 12 12 12 12 12 12 12
12 12 12 12 12 12 12 12 12 12 18 31 26 26 26 26 26 26 26 26 26 26 30 10 10 10 31 26 26 26 26 26 26 26 26 26 26 30 17 12 12 12 12 12 12 12 12 12 12 12
12 12 12 12 12 12 12 12 12 12 18 31 26 26 26 26 26 26 26 26 26 26 30 10 10 10 31 26 26 26 26 26 26 26 26 26 26 30 17 12 12 12 12 12 12 12 12 12 12 12
12 12 12 12 12 12 12 12 12 12 18 31 26 26 26 26 26 26 26 26 26 26 30 10 10 10 31 26 26 26 26 26 26 26 26 26 26 30 17 12 12 12 12 12 12 12 12 12 12 12
12 12 12 12 12 12 12 12 12 12 18 31 26 26 26 26 26 26 26 26 26 26 30 10 10 10 31 26 26 26 26 26 26 26 26 26 26 30 17 12 12 12 12 12 12 12 12 12 12 12
12 12 12 12 12 12 12 12 12 12 18 31 26 26 26 26 26 26 26 26 26 26 30 10 10 10 31 26 26 26 26 26 26 26 26 26 26 30 17 12 12 12 12 12 12 12 12 12 12 12
12 12 12 12 12 12 12 12 12 12 18 31 26 26 26 26 26 26 26 26 26 26 30 10 10 10 31 26 26 26 26 26 26 26 26 26 26 30 17 12 12 12 12 12 12 12 12 12 12 12
12 12 12 12 12 12 12 12 12 12 18 31 26 26 26 26 26 26 26 26 26 26 30 10 10 10 31 26 26 26 26 26 26 26 26 26 26 30 17 12 12 12 12 12 12 12 12 12 12 12
12 12 12 12 12 12 12 12 12 12 18 31 26 26 26 26 26 26 26 26 26 26 30 10 10 10 31 26 26 26 26 26 26 26 26 26 26 30 17 12 12 12 12 12 12 12 12 12 12 12
12 12 12 12 12 12 12 12 12 12 18 37 28 28 28 28 28 28 28 28 28 28 38 10 10 10 37 28 28 28 28 28 28 28 28 28 28 38 17 12 12 12 12 12 12 12 12 12 12 12
12 12 12 12 12 12 12 12 12 12 18 10 10 10 10 10 10 10 10 10 10 10 10 10 10 10 10 10 10 10 10 10 10 10 10 10 10 10 17 12 12 12 12 12 12 12 12 12 12 12
12 12 12 12 12 12 12 12 12 12 18 10 10 10 10 10 10 10 10 10 10 10 10 10 10 10 10 10 10 10 10 10 10 10 10 10 10 10 17 12 12 12 12 12 12 12 12 12 12 12
12 12 12 12 12 12 12 12 12 12 18 10 10 10 10 10 10 10 10 10 10 10 10 10 10 10 10 10 10 10 10 10 10 10 10 10 10 10 17 12 12 12 12 12 12 12 12 12 12 12
12 12 12 12 12 12 12 12 12 12 18 35 33 33 33 33 33 33 33 33 33 33 36 10 10 10 35 33 33 33 33 33 33 33 33 33 33 36 17 12 12 12 12 12 12 12 12 12 12 12
12 12 12 12 12 12 12 12 12 12 18 31 26 26 26 26 26 26 26 26 26 26 30 10 10 10 31 26 26 26 26 26 26 26 26 26 26 30 17 12 12 12 12 12 12 12 12 12 12 12
12 12 12 12 12 12 12 12 12 12 18 31 26 26 26 26 26 26 26 26 26 26 30 10 10 10 31 26 26 26 26 26 26 26 26 26 26 30 17 12 12 12 12 12 12 12 12 12 12 12
12 12 12 12 12 12 12 12 12 12 18 31 26 26 26 26 26 26 26 26 26 26 30 10 10 10 31 26 26 26 26 26 26 26 26 26 26 30 17 12 12 12 12 12 12 12 12 12 12 12
12 12 12 12 12 12 12 12 12 12 18 31 26 26 26 26 26 26 26 26 26 26 30 10 10 10 31 26 26 26 26 26 26 26 26 26 26 30 17 12 12 12 12 12 12 12 12 12 12 12
12 12 12 12 12 12 12 12 12 12 18 31 26 26 26 26 26 26 26 26 26 26 30 10 10 10 31 26 26 26 26 26 26 26 26 26 26 30 17 12 12 12 12 12 12 12 12 12 12 12
12 12 12 12 12 12 12 12 12 12 18 31 26 26 26 26 26 26 26 26 26 26 30 10 10 10 31 26 26 26 26 26 26 26 26 26 26 30 17 12 12 12 12 12 12 12 12 12 12 12
12 12 12 12 12 12 12 12 12 12 18 31 26 26 26 26 26 26 26 26 26 26 30 10 10 10 31 26 26 26 26 26 26 26 26 26 26 30 17 12 12 12 12 12 12 12 12 12 12 12
12 12 12 12 12 12 12 12 12 12 18 31 26 26 26 26 26 26 26 26 26 26 30 10 10 10 31 26 26 26 26 26 26 26 26 26 26 30 17 12 12 12 12 12 12 12 12 12 12 12
12 12 12 12 12 12 12 12 12 12 18 31 26 26 26 26 26 26 26 26 27 28 38 10 10 10 37 28 29 26 26 26 26 26 26 26 26 30 17 12 12 12 12 12 12 12 12 12 12 12
12 12 12 12 12 12 12 12 12 12 18 31 26 26 26 26 26 26 26 26 30 40 40 40 39 40 40 40 31 26 26 26 26 26 26 26 26 30 17 12 12 12 12 12 12 12 12 12 12 12
12 12 12 12 12 12 12 12 12 12 18 37 28 28 28 28 28 28 28 28 38 40 39 39 39 39 39 40 37 28 28 28 28 28 28 28 28 38 17 12 12 12 12 12 12 12 12 12 12 12
12 12 12 12 12 12 12 12 12 12 24 15 15 15 15 15 15 15 15 15 16 40 39 39 39 39 39 40 14 15 15 15 15 15 15 15 15 15 25 12 12 12 12 12 12 12 12 12 12 12
12 12 12 12 12 12 12 12 12 12 12 12 12 12 12 12 12 12 12 12 18 40 40 40 40 40 40 40 17 12 12 12 12 12 12 12 12 12 12 12 12 12 12 12 12 12 12 12 12 12
12 12 12 12 12 12 12 12 12 12 12 12 12 12 12 12 12 12 12 12 24 15 15 15 15 15 15 15 25 12 12 12 12 12 12 12 12 12 12 12 12 12 12 12 12 12 12 12 12 12
12 12 12 12 12 12 12 12 12 12 12 12 12 12 12 12 12 12 12 12 12 12 12 12 12 12 12 12 12 12 12 12 12 12 12 12 12 12 12 12 12 12 12 12 12 12 12 12 12 12
12 12 12 12 12 12 12 12 12 12 12 12 12 12 12 12 12 12 12 12 12 12 12 12 12 12 12 12 12 12 12 12 12 12 12 12 12 12 12 12 12 12 12 12 12 12 12 12 12 12
12 12 12 12 12 12 12 12 12 12 12 12 12 12 12 12 12 12 12 12 12 12 12 12 12 12 12 12 12 12 12 12 12 12 12 12 12 12 12 12 12 12 12 12 12 12 12 12 12 12
12 12 12 12 12 12 12 12 12 12 12 12 12 12 12 12 12 12 12 12 12 12 12 12 12 12 12 12 12 12 12 12 12 12 12 12 12 12 12 12 12 12 12 12 12 12 12 12 12 12
12 12 12 12 12 12 12 12 12 12 12 12 12 12 12 12 12 12 12 12 12 12 12 12 12 12 12 12 12 12 12 12 12 12 12 12 12 12 12 12 12 12 12 12 12 12 12 12 12 12
12 12 12 12 12 12 12 12 12 12 12 12 12 12 12 12 12 12 12 12 12 12 12 12 12 12 12 12 12 12 12 12 12 12 12 12 12 12 12 12 12 12 12 12 12 12 12 12 12 12
12 12 12 12 12 12 12 12 12 12 12 12 12 12 12 12 12 12 12 12 12 12 12 12 12 12 12 12 12 12 12 12 12 12 12 12 12 12 12 12 12 12 12 12 12 12 12 12 12 12
12 12 12 12 12 12 12 12 12 12 12 12 12 12 12 12 12 12 12 12 12 12 12 12 12 12 12 12 12 12 12 12 12 12 12 12 12 12 12 12 12 12 12 12 12 12 12 12 12 12
12 12 12 12 12 12 12 12 12 12 12 12 12 12 12 12 12 12 12 12 12 12 12 12 12 12 12 12 12 12 12 12 12 12 12 12 12 12 12 12 12 12 12 12 12 12 12 12 12 12
